+--+--+--+--+--+--+--+--+--+--+--+--+--+--+--+--+--+--+--+--+
|>    |                 | r                  |             d|
+--+  +--+  +--+--+--+  +--+--+--+  +--+--+  +  +--+--+--+  +
|  |    l|           |           |  |        |  |     |     |
+  +--+  +--+--+--+  +  +--+  +--+  +  +--+--+  +  +  +  +--+
|        |     |     |  |     |     |        |  |  |     |  |
+--+  +--+  +  +  +--+--+  +--+  +--+--+--+  +  +  +--+--+  +
|     |     |     |              |  |     |  |  |  |        |
+  +--+  +--+--+--+  +--+  +--+--+  +  +--+  +  +  +  +  +  +
|     |     |     |  |  |  |     |        |  |  |     |  |  |
+--+  +--+  +  +--+  +  +  +  +  +--+  +  +  +  +--+--+--+  +
|           |        |     |  |        |     |  |           |
+  +--+--+  +  +--+--+--+--+--+--+--+  +--+--+  +  +--+--+--+
|        |  |  |  r     |     |  |     |        |  |     |  |
+--+--+--+  +--+  +--+  +--+  +  +  +--+  +  +--+  +  +  +  +
|  |        |     |  |     |  |  |        |  |  |     |  |  |
+  +  +--+--+  +--+  +  +  +  +  +--+--+--+  +  +  +--+  +  +
|     |     |        |  |     |           |  |  |     |     |
+  +--+  +  +--+--+--+  +--+--+  +--+--+  +  +  +--+  +--+--+
|        |                       |        |     |            
+--+--+--+--+--+--+--+--+--+--+--+--+--+--+--+--+--+--+--+--+
